20 20 0
*OO#OOOOOOOOOOOOOOOO
OOO#OOOOOOOOOOOOOOOO
OOO#OOOOOOOOOOOOOOOO
OOO#OOOOOOOOOOOOOOOO
OOO#OOO#OOOOOOOOOOOO
OOO###O#OOOOOOOOOOOO
OOOOOOO####O#OOOOOOO
OOOOOOOOOO#O#OOOOOOO
OOO####OOO#O#OOOAOOO
OOO#OOOOOO#O#OOOOOOO
OOO#OO#####O#OOOOOOO
OOO#OO#OOOOO#OOOOOOO
OOO#OO#OO####OOOOOOO
OOO#OOOOOOO#OOOOOOOO
OOO#OO####O#OOOOOOOO
OOO#OO#OOOO#OOOOOOOO
OOO#OO#O##O#OOOOOOOO
OOO#OOOO#OO#OOOOOOOO
OOOOO####OO#OOOOOOOO
OOOOOOOOOO%#OOOOOOOO